#.#...#...####...###
....#.#.#....#.#....
.#.##.#.#.##.#.#.##.
.#.#....#..#...#..#.
.#.#.#####..####.##.
.##..#....#.........
..#.##.##..#.###.#.#
#.#.##.#.#.#.....#.#
#.#..#...#.#######.#
#.##.##.##..#...##.#
#.#....#...####.#..#
#.#.####.##...#.#.##
#.#.......#.#.#.#...
#.#.###.#.#.#.....#.
#...........###.###.
#####.###.####..#...
........#....#.##.#.
#.#####.##.#.#.##.#.
#..........#...#....
#####.###.####...#.#